10 9 4
XX.XXXX
XXXX..XXXX
 X.J.JG..X
XX.X..GJ.X
X...XXGXXX
X..J..G.X
X.M.X...X
X..XXXXXX
XXXX
