7 7 4
 XXXXX
XXG.GXX
X.*.*.X
X..X..X
X.J.J.X
XX.M.XX
 XXXXX
