8 6 3
XXXXXXXX
X......X
X.G**JMX
X......X
XXXXX..X
    XXXX
