8 10 3
XXXX
X..XXXXX
X.JJ.J.X
X......X
XX.XX.XX
XGGGXMX
X.XXX.XX
X......X
X..X...X
XXXXXXXX
