11 11 5
 XXXXXX
 X.G..X
XXJGX.X
X..*..X
X.GGXXX
XXJ.X.XXXXX
XX.XX.X...X
X..XXXX.X.X
X...M.J.J.X
XX..X.....X
 XXXXXXXXXX
