9 9 3
     XXXX
     X.MX
     X..X
XXXXXX.GX
X...J..GX
X..JJX.GX
X....XXXX
XXX..X
  XXXX
