7 6 3
 XXXXX
 X...X
XX...XX
X.JJJ.X
X.G+G.X
XXXXXXX
