6 8 4
  XXXX
XXX.MX
X..J.X
X..*GX
X..*GX
X..J.X
XXX..X
  XXXX
