9 10 4
XXXXXXXX
X......X
X.XXXX.X
X.XGGGMX
X.XXXJXXX
X.X.....X
X..JJ.J.X
XXXX...XX
   XGXXX
   XXX
