10 8 5
 XXXXXXX
 X..G.GXXX
 X.G.G.G.X
XXX.XXXX.X
X..MJ..J.X
X..JJ..J.X
XXXX...XXX
   XXXXX
