6 7 3
XXXXXX
XGGG.X
X..J.X
X.XJXX
X..J.X
X..M.X
XXXXXX
