8 8 4
  XXXXX
  X.G.XX
XXX.J..X
X.G.JXMX
X.XJ.G.X
X..J.XXX
XX.G.X
 XXXXX
