7 7 3
XXXXXXX
XG.X..X
X..J..X
XG.JXMX
X..J..X
XG.X..X
XXXXXXX
