8 7 2
XXXX
X..XXX
X....XXX
X..J*M.X
XXX.GX.X
  X....X
  XXXXXX
