10 8 3
 XXXX
 X..XXXX
 X.....XX
XX.XX...X
XG.GX.MJXX
X...X.JJ.X
X..GX....X
XXXXXXXXXX
