11 8 4
XXXXXXXXXXX
XGGGGX....X
X..X...JJ.X
X..M..XX..X
X.....XXJ.X
XXXXXX..J.X
     X....X
     XXXXXX
