7 7 3
 XXXX
 X..XXX
 X.JJ.X
XXGGG.X
X..MJ.X
X...XXX
XXXXX
