11 8 4
 XXXX
 X..XXXXXXX
 XJ.MX...GX
XX.XJJ...GX
X..J..XXGGX
X...X.XXXXX
XXX...X
  XXXXX
