9 14 3
   XXX
   XMX
 XXXJXXX
XX..G..XX
X..X.X..X
X.X...X.X
X.X...X.X
X.X...X.X
X..X.X..X
XX.J.J.XX
 XXG.GXX
  X...X
  X...X
  XXXXX
