9 12 6
XXXXXX
X....XXXX
X....GGGX
X....GGGX
XXXXXX..X
  X..X..X
  X.JJ.XX
  X.MJ..X
  X.JJ..X
  XX.JX.X
   X....X
   XXXXXX
