10 7 2
  XXXX
XXX..XXXXX
X..J..MGGX
X.J....X.X
XXX.XXXX.X
  X......X
  XXXXXXXX
