6 9 3
 XXXXX
 X...X
 X.G.X
XX.*.X
X..*XX
X..MXX
XX.J.X
 X...X
 XXXXX
