9 6 2
  XXXX
XXX..XXXX
X.....J.X
X.X..XJ.X
X.G.GXM.X
XXXXXXXXX
