10 12 4
 XXXX
XX..XXX
XMJ...X
XXX.J.X
 X..XXXXXX
 X..JGGGGX
 X..X.XXXX
 XX.X.X
 X.JX.X
 X....X
 X..XXX
 XXXX
