10 8 4
XXXX
X.MXXX
XG*..XXXXX
XGGXJJ.J.X
XX.......X
 X.X.XX..X
 X...XXXXX
 XXXXX
