13 8 4
      XXXXX
      X...XX
      X.J..X
XXXXXXXX.XMXX
X.G..X.J.J..X
X........JX.X
XGGGXXXXX...X
XXXXX   XXXXX
