10 10 4
 XXXXXXXXX
 X.......X
XXMXXXXX.X
X..X...X.X
X..X...JGX
X..XXJXXGX
XXJXX..XGX
X...J..XGX
X...X..XXX
XXXXXXXX
