11 11 3
  XXXXXX
  X....X
  X....X
XXXXX..X
X...XGXXXXX
X...JMJ...X
XXXXXGX...X
   XX.XX.XX
   X...JGX
   X...XXX
   XXXXX
