8 10 3
XXXXXX
X.M..X
X.JX.X
X.J..X
X.J.XX
XXX.XXXX
 X..X..X
 XGGG..X
 X.....X
 XXXXXXX
