12 7 4
XXXXX..XXXXX
X...XXXXGG.X
X.JJJ......X
X...JX..GG.X
XXX.MX..XX.X
  X..XX....X
  XXXXXXXXXX
