9 8 2
XXXXXXX
X.....XXX
X..MJJGGX
XXXX.XX.X
  X.....X
  X..XXXX
  X..X
  XXXX
