9 9 4
  XXXX
  X..X
  X.JXXXX
XXXG.G..X
X.J.X.J.X
X..G.GXXX
XXXXJ.X
   X.MX
   XXXX
