11 12 5
XXXXX
X...XXX
X.XJ..X
X.J...X
X.J.J.X
X.JX..X
X..MXXX
XX.XXXXXXXX
X......GGGX
X.........X
XXXXXXXXGGX
       XXXX
