9 10 3
  XXXXXX
  X....XX
 XX.XX..X
 X.JJ.X.X
 X.MJ.X.X
 X....X.X
XXXX.X..X
X..GGG.XX
X.....XX
XXXXXXX
