12 7 7
 XXXXXXXXXXX
XXGGGGGGG..X
X.JJJJJJJM.X
X...X.X.X.XX
X.X.X.....X
X...XXXXXXX
XXXXX
