12 10 3
       XXXXX
XXXXXXXX...X
XG...G..MXGX
X..XXX.....X
XX.J..X....X
 X.J...XXXXX
 X.JX..X
 XX.X..X
  X...XX
  XXXXX
