8 6 3
XXXXXXX
X.....X
XMJJJ.XX
X..XGGGX
XX....XX
 XXXXXX
