10 11 4
XXXX
X..XXXXXXX
X..G.XX.GX
X.JX....GX
XX.XX.X.GX
 X....X..X
 XXXX.X..X
  X.MJ.XXX
  X.JJ.X
  X....X
  XXXXXX
