6 7 3
XXXX
X..XXX
X.JJ.X
XGGG.X
X.MJ.X
X...XX
XXXXX
