13 6 4
   XXXXXXXXXX
XXXX....XX..X
X..JJJGGGGJMX
X......XXX..X
X...XXXX.XXXX
XXXXX
