8 8 8
XXXXXXXX
XM.....X
X.GJJG.X
X.JGGJ.X
X.JGGJ.X
X.GJJG.X
X......X
XXXXXXXX
