8 8 3
XXXXXX
X..M.X
X..X.XX
X.GX..XX
X.GJJJ.X
X.GX...X
XXXX...X
   XXXXX
