8 8 11
XXXXXXXX
X......X
X.J***.X
X.*..*.X
X.*..*.X
X.***G.X
X.....MX
XXXXXXXX
