9 8 4
 XXXXXXX
 X.....X
XX.XXXJXX
XGJ...M.X
X.GG.XJ.X
XGXX..J.X
X....XXXX
XXXXXX
