11 8 3
      XXXXX
      XG..X
      XGX.X
XXXXXXXGX.X
X.M.J.J.J.X
X.X.X.X.XXX
X.......X
XXXXXXXXX
