19 6 2
XXXXX...XXXX
X...XXXXX.GX
X.......J..XXXXXXXX
XXX..XXXX.GJ....M.X
  X..X..X..XXXX...X
  XXXX..XXXX..XXXXX
