7 8 3
XXXXX
X...XX
X.X..X
XMJ*GXX
XX..G.X
 X.JX.X
 XX...X
  XXXXX
