10 9 6
  XXXXXXXX
  X..X.G.X
  X...G*GX
  X..X.*.X
XXXXJXXGXX
X......J.X
X.J.XX.J.X
X...MX...X
XXXXXXXXXX
