7 7 2
XXXXX
X...X
X.M.X
X.JJXXX
XXG.G.X
 X....X
 XXXXXX
