9 15 6
XXXX
X..XXXX
X.J...X
X.GX..X
X.JX.XX
X.G..X
XXXX.X
   X.X
 XXX.XXX
 X..J..X
XX.XJX.XX
X.J.M.J.X
X.GGXGG.X
XXX...XXX
  XXXXX
