10 7 3
 XXXX
 X..XXXXXX
XX....J..X
X.GX.J...X
X.GXJXXXXX
X.GM.X
XXXXXX
