11 9 2
     XXXXX
     X...XX
     X....X
 XXXXXX...X
XX.....XG.X
X.J.J.M..XX
X.XXXXXXGX
X........X
XXXXXXXXXX
