15 11 5
XXXXXXXX
X......X
X.J.JJ.XXXXXXXX
XXXXX.MXXG.G..X
    XJ..X.G...X
    X...XG.G.XX
    XJX.XX.X.X
    X........X
    X..XXX..XX
    X..X.XXXX
    XXXX
