15 8 4
XXXX.....XXXXX
X..XXX...X...XX
X....X...XJ.J.X
XGGX.XXXXX.X..X
X..M....X.J.J.X
XGGX.........XX
XX...XXXXXXXXX
 XXXXX
