11 7 2
  XXXXXXX
XXX.....X
X.J.J...X
X.XXX.XXXXX
X.M.G.G...X
X...XXX...X
XXXXX XXXXX
