7 6 2
XXXX
X..XXXX
X.G.G.X
X.JJXMX
XX....X
 XXXXXX
