11 7 4
XXXXXXXXXX
X.M.GGGG.X
X...XXXXJXX
XX.X..J.J.X
 X.J......X
 X...XXXXXX
 XXXXX
