13 13 5
  XXXXX
  X...X
  X.X.XXXXXXX
  X..*..X...X
  XX.XX...X.X
  X.....X*..X
XXX.X.X.X.XXX
X..*XJ+...X
X.X...XX.XX
X...X..*..X
XXXXXXX.X.X
      X...X
      XXXXX
