11 11 8
 XXXXXXXXX
XX...X...XX
X....X....X
X..J.X.J..X
X...*G*...X
XXXXGMGXXXX
X...*G*...X
X..J.X.J..X
X....X....X
XX...X...XX
 XXXXXXXXX
