13 10 10
XXXXXXXXXXXXX
XGX.MX..X...X
XGXJJ...X.J.X
XGX..X.JX...X
XGX.JX..X.JXX
XGX..X.JX..X
XGX.JX..X.JX
XGG..X.J...X
XGG..X..X..X
XXXXXXXXXXXX
