12 6 3
XXXXXX.XXXXX
X....XXX...X
X.JJ.....XMX
X.J.XGGG...X
X...XXXXXXXX
XXXXX
