13 9 2
XXXXXXXXXXX
X.....X...XXX
X.JMJ.X.G..GX
X.XX.XXX.XX.X
X.X.......X.X
X.X...X...X.X
X.XXXXXXXXX.X
X...........X
XXXXXXXXXXXXX
