6 7 3
XXXXX
X.M.X
XGGGX
XJJJXX
X....X
X....X
XXXXXX
