8 10 4
XXXXXX
X....XX
X.J.J.XX
XX.JJ..X
 X.X...X
 X.XX.XX
 X..G.GX
 X.MG.GX
 X..XXXX
 XXXX
