9 8 4
    XXXX
  XXX..XX
 XX.J...X
XX.J..X.X
X.MXJJ..X
X.GG..XXX
X.GGXXX
XXXXX
