9 8 2
XXXXX
X...XX
X.J..X
XX.J.XXXX
 XXXMG..X
  X..GX.X
  X.....X
  XXXXXXX
