7 7 3
XXXX
X..XXXX
XG*J..X
X.GJX.X
XX.M..X
 X...XX
 XXXXX
