9 9 7
 XXXX
 X..XX
 XJG.X
 XGJ.XXXX
XX.GJGM.X
X..JGJ..X
X.JG.XXXX
X.GJ.X
XXXXXX
