9 9 8
  XXXX
  X..XXXX
  X.*...X
XXX.GGGGX
X..J*JJ.X
X...G.XXX
XXXJ*JMX
  X....X
  XXXXXX
