9 9 6
   XXXX
   X..X
XXXXG.XXX
X..JJJM.X
X..GG.X.X
XXJJJ...X
 XGGGXXXX
 XX..X
  XXXX
