11 12 13
 XXXXXXXX
 X...M..XXX
XX.XX.X...X
X..XX...J.X
X.JXXJXX.XX
X.J.GJGJJX
XXJGGGGG.X
 X.GXJXGJX
 X.GGJGG.X
 XXXXX.JJX
     X...X
     XXXXX
