8 9 6
  XXXX
  X..XXX
  X..J.X
XXX*.*.X
X..*.G.X
X...X*.X
XX.*.MXX
 X..XXX
 XXXX
