9 10 6
XXXXXXXX
X..X...X
X.J.MXJX
X..X...X
XX.G.GJX
XX.XXG.XX
X..XXG..X
X.JGJGJ.X
X..XXXXXX
XXXX
