9 12 7
   XXXX  
XXXX..X  
X.J...X  
X.JX..XXX
X.MX.X..X
X.XX.J..X
XG*..X..X
XG*GG*.XX
XX.XXX.XX
X....J..X
X...X...X
XXXXXXXXX
