11 11 12
 XXXXX
 X.+.X
 XJGJX
 X.*.X
 X.*.X
 X.*.XXXXXX
XX.*.J....X
X..*.**G*GX
X....J....X
XX..XXXXXXX
 XXXX
