8 9 6
  XXXX
XXX.MX
X..J.XXX
XGJGJ..X
X.GJG..X
XGJXJXXX
X.G..X
X..XXX
XXXX
