9 9 7
  XXXX
  X..X
XXX.*XXXX
X.J..G..X
X..*...*X
XXXM*.*.X
  XX.*..X
   XXX..X
     XXXX
