8 9 6
 XXXX
 XM.X
XXGJXXX
X.J.J.X
X.GJG.XX
X.JGJ..X
XXGXG..X
 X...XXX
 XXXXX
