9 11 7
  XXXXX
 XX...X
 X..X.XX
XX*G...X
X.*GX..X
XMX*J..X
X.*G.X.X
XXJX.X.XX
X.J.....X
X...X...X
XXXXXXXXX
