10 10 7
   XXXXX
 XXX...XX
 X......X
 X.XGGX.XX
 XJX****GX
 X.......X
XX.XXXX.XX
XMJJ.....X
X...XX...X
XXXXXXXXXX
