11 11 8
 XXXXXXXXX
 X...XX..X
 X....J..X
 XX.X*XJ.X
 X..*GX.XX
XXJXM*G.XXX
X..G*GX...X
X.J.X...X.X
X....XX...X
XX...XXXXXX
 XXXXX
