9 10 5
XXXXXXXXX
X...X...X
X....JJMX
XX.XXX.XX
 X..GG.X.
XX..XX.X.
XG**XXJXX
X.......X
XXXXX...X
    XXXXX
