9 9 6
   XXXX
   XM.X
  XXJ.XXX
  X.*...X
XXX..*..X
X..*.*XXX
X..*..X
XXX.G.X
  XXXXX
