8 10 7
XXXXX
X...XX
X.JG.X
XXJG.X
 X.G.X
 XJGJXXX
 XMGJ..X
 XJGJG.X
 X...XXX
 XXXXX
