9 9 5
XXXXX
X...XXXX
X..JGJ.XX
XXJXMX..X
 X.GGG..X
XXJXGX.XX
X...J...X
X...X...X
XXXXXXXXX
