9 9 6
  XXXXX
  X...XXX
  X.GJG.X
XXXJGJM.X
X.G.GJXXX
X..JG.X
XX.XXJX
 X....X
 XXXXXX
