9 11 7
   XXXX
   X..XXX
   X....X
 XXX..X.X
 XM****GX
 X.X.*GXX
 X.X...X
XX.XJX.XX
X...J...X
X...X...X
XXXXXXXXX
